##################################################
##################################################
####.#############################################
##....######################.#.#.#################
####.####.............#####.......########.#.#####
##.#.####.........................#######.....####
#....####.............#####.......##.........#####
#....##########..###.###.###.#.#..............####
#....#######.#...#.#......####.#.###...###.#.#####
#...#######...........##.##.......###.######.#####
#...#######...........##.##.......###.#.........##
##.########...........##..........###.#.........##
##.#########.#.#.#.#.######.......###...........##
##.........#########.######.......#####.........##
##.........#######.....################.........##
##.........######.."""..################.#########
###.#############.."."........##.............#####
###.#############.."""..#####.##.............#####
###.##############.....######.##.............#####
##...#####...###############...#.............#####
#.....####...###########.....................#####
#.........................##...#.............#####
#.....####...#########....###~##.............#####
##...#####...#########....###~##########.#.#.#####
###.#######.##########.#.####~############.....###
###.#######.......####.#.####~############.....###
###.#######....................................###
##.......................#.....................###
###.################.....#...........#####.....###
##################################################
##################################################