##################################################
##################################################
####.#############################################
##....######################.#.#.#################
####.####.............#####.......########.#.#####
##.#.####.........................#######.....####
#....####.............#####.......##.........#####
#....##########..###.###.###.#.#..............####
#....#######.#...#.#......####.#.###...###.#.#####
#...#######...........##.##.......###.######.#####
#...#######...........##.##.......###.#.........##
##.########...........##..........###.#.........##
##.#########.#.#.#.#.######.......###...........##
##.........#########.######.......#####.........##
##.........#######.....################.........##
##.........######.......################.#########
###.#############.............##.............#####
###.#############.......#####.##.............#####
###.##############.....######.##.............#####
##...#####...###############...#.............#####
#.....####...###########.....................#####
#.........................##...#.............#####
#.....####...#########....###.##.............#####
##...#####...#########....###.##########.#.#.#####
###.#######.##########.#.####.############.....###
###.#######.......####.#.####.############.....###
###.#######....................................###
##.......................#.....................###
###.################.....#...........#####.....###
##################################################
##################################################