#########################
#.......................#
#.....".................#
#.....".................#
#.....".................#
#.....".................#
#.~~~~#.................#
#.....#.................#
#.....#.................#
#.....#.................#
#.....#.................#
#.....#.................#
#.....######............#
#..........#............#
#########################