####################
####################
####################
####################
####################
#######...##########
#######...####...###
#######...##.....###
########.###.#...###
########.....#######
##########.#########
##########.#########
##########.#########
##########.#########
########.....#######
########.....#######
########.....#######
####################
####################

