####################
#"""""######.~.#####
#."""........~.#####
#.".".######.~.#####
#.""".##############
#..####...##########
##........####...###
#######...##.....###
########.###.#...###
####.###.....##~####
###...####.####~####
##.........####~####
###...####.###~~~~##
####.#####.###~..~##
####.###....##~~~~##
####.###.....#######
##...###.....#######
##...###############
####################

